char_maps["IBM-0500"] = {
      0 => "\u0000",
      1 => "\u0001",
      2 => "\u0002",
      3 => "\u0003",
      4 => "\u0000",
      5 => "\t",
      6 => "\u0000",
      7 => "\u007F",
      8 => "\u0000",
      9 => "\u0000",
     10 => "\u0000",
     11 => "\v",
     12 => "\f",
     13 => "\r",
     14 => "\u000E",
     15 => "\u000F",
     16 => "\u0010",
     17 => "\u0011",
     18 => "\u0012",
     19 => "\u0013",
     20 => "\u0000",
     21 => "\u0085",
     22 => "\b",
     23 => "\u0000",
     24 => "\u0018",
     25 => "\u0019",
     26 => "\u0000",
     27 => "\u0000",
     28 => "\u001C",
     29 => "\u001D",
     30 => "\u001E",
     31 => "\u001F",
     32 => "\u0000",
     33 => "\u0000",
     34 => "\u0000",
     35 => "\u0000",
     36 => "\u0000",
     37 => "\n",
     38 => "\u0017",
     39 => "\e",
     40 => "\u0000",
     41 => "\u0000",
     42 => "\u0000",
     43 => "\u0000",
     44 => "\u0000",
     45 => "\u0005",
     46 => "\u0006",
     47 => "\a",
     48 => "\u0000",
     49 => "\u0000",
     50 => "\u0016",
     51 => "\u0000",
     52 => "\u0000",
     53 => "\u0000",
     54 => "\u0000",
     55 => "\u0004",
     56 => "\u0000",
     57 => "\u0000",
     58 => "\u0000",
     59 => "\u0000",
     60 => "\u0014",
     61 => "\u0015",
     62 => "\u0000",
     63 => "\u001A",
     64 => " ",
     65 => "\u00A0",
     66 => "\u00E2",
     67 => "\u00E4",
     68 => "\u00E0",
     69 => "\u00E1",
     70 => "\u00E3",
     71 => "\u00E5",
     72 => "\u00E7",
     73 => "\u00F1",
     74 => "[",
     75 => ".",
     76 => "<",
     77 => "(",
     78 => "+",
     79 => "!",
     80 => "&",
     81 => "\u00E9",
     82 => "\u00EA",
     83 => "\u00EB",
     84 => "\u00E8",
     85 => "\u00ED",
     86 => "\u00EE",
     87 => "\u00EF",
     88 => "\u00EC",
     89 => "\u00DF",
     90 => "]",
     91 => "$",
     92 => "*",
     93 => ")",
     94 => ";",
     95 => "^",
     96 => "-",
     97 => "/",
     98 => "\u00C2",
     99 => "\u00C4",
    100 => "\u00C0",
    101 => "\u00C1",
    102 => "\u00C3",
    103 => "\u00C5",
    104 => "\u00C7",
    105 => "\u00D1",
    106 => "\u00A6",
    107 => ",",
    108 => "%",
    109 => "_",
    110 => ">",
    111 => "?",
    112 => "\u00F8",
    113 => "\u00C9",
    114 => "\u00CA",
    115 => "\u00CB",
    116 => "\u00C8",
    117 => "\u00CD",
    118 => "\u00CE",
    119 => "\u00CF",
    120 => "\u00CC",
    121 => "`",
    122 => ":",
    123 => "#",
    124 => "@",
    125 => "'",
    126 => "=",
    127 => "\"",
    128 => "\u00D8",
    129 => "a",
    130 => "b",
    131 => "c",
    132 => "d",
    133 => "e",
    134 => "f",
    135 => "g",
    136 => "h",
    137 => "i",
    138 => "\u00AB",
    139 => "\u00BB",
    140 => "\u00F0",
    141 => "\u00FD",
    142 => "\u00FE",
    143 => "\u00B1",
    144 => "\u00B0",
    145 => "j",
    146 => "k",
    147 => "l",
    148 => "m",
    149 => "n",
    150 => "o",
    151 => "p",
    152 => "q",
    153 => "r",
    154 => "\u00AA",
    155 => "\u00BA",
    156 => "\u00E6",
    157 => "\u00B8",
    158 => "\u00C6",
    159 => "\u00A4",
    160 => "\u00B5",
    161 => "~",
    162 => "s",
    163 => "t",
    164 => "u",
    165 => "v",
    166 => "w",
    167 => "x",
    168 => "y",
    169 => "z",
    170 => "\u00A1",
    171 => "\u00BF",
    172 => "\u00D0",
    173 => "\u00DD",
    174 => "\u00DE",
    175 => "\u00AE",
    176 => "\u00A2",
    177 => "\u00A3",
    178 => "\u00A5",
    179 => "\u00B7",
    180 => "\u00A9",
    181 => "\u00A7",
    182 => "\u00B6",
    183 => "\u00BC",
    184 => "\u00BD",
    185 => "\u00BE",
    186 => "\u00AC",
    187 => "|",
    188 => "\u00AF",
    189 => "\u00A8",
    190 => "\u00B4",
    191 => "\u00D7",
    192 => "{",
    193 => "A",
    194 => "B",
    195 => "C",
    196 => "D",
    197 => "E",
    198 => "F",
    199 => "G",
    200 => "H",
    201 => "I",
    202 => "\u00AD",
    203 => "\u00F4",
    204 => "\u00F6",
    205 => "\u00F2",
    206 => "\u00F3",
    207 => "\u00F5",
    208 => "}",
    209 => "J",
    210 => "K",
    211 => "L",
    212 => "M",
    213 => "N",
    214 => "O",
    215 => "P",
    216 => "Q",
    217 => "R",
    218 => "\u00B9",
    219 => "\u00FB",
    220 => "\u00FC",
    221 => "\u00F9",
    222 => "\u00FA",
    223 => "\u00FF",
    224 => "\\",
    225 => "\u00F7",
    226 => "S",
    227 => "T",
    228 => "U",
    229 => "V",
    230 => "W",
    231 => "X",
    232 => "Y",
    233 => "Z",
    234 => "\u00B2",
    235 => "\u00D4",
    236 => "\u00D6",
    237 => "\u00D2",
    238 => "\u00D3",
    239 => "\u00D5",
    240 => "0",
    241 => "1",
    242 => "2",
    243 => "3",
    244 => "4",
    245 => "5",
    246 => "6",
    247 => "7",
    248 => "8",
    249 => "9",
    250 => "\u00B3",
    251 => "\u00DB",
    252 => "\u00DC",
    253 => "\u00D9",
    254 => "\u00DA",
    255 => "\u0000"
}