char_maps["IBM-1047"] = {
      0 => 0,
      1 => 1,
      2 => 2,
      3 => 3,
      4 => 128,
      5 => 9,
      6 => 129,
      7 => 127,
      8 => 130,
      9 => 131,
     10 => 132,
     11 => 11,
     12 => 12,
     13 => 13,
     14 => 14,
     15 => 15,
     16 => 16,
     17 => 17,
     18 => 18,
     19 => 19,
     20 => 134,
     21 => 133,
     22 => 8,
     23 => 135,
     24 => 24,
     25 => 25,
     26 => 136,
     27 => 137,
     28 => 28,
     29 => 29,
     30 => 30,
     31 => 31,
     32 => 138,
     33 => 139,
     34 => 140,
     35 => 141,
     36 => 142,
     37 => 10,
     38 => 23,
     39 => 27,
     40 => 143,
     41 => 144,
     42 => 145,
     43 => 146,
     44 => 147,
     45 => 5,
     46 => 6,
     47 => 7,
     48 => 148,
     49 => 149,
     50 => 22,
     51 => 150,
     52 => 151,
     53 => 152,
     54 => 153,
     55 => 4,
     56 => 154,
     57 => 155,
     58 => 156,
     59 => 157,
     60 => 20,
     61 => 21,
     62 => 158,
     63 => 26,
     64 => 32,
     65 => 160,
     66 => 226,
     67 => 228,
     68 => 224,
     69 => 225,
     70 => 227,
     71 => 229,
     72 => 231,
     73 => 241,
     74 => 162,
     75 => 46,
     76 => 60,
     77 => 40,
     78 => 43,
     79 => 124,
     80 => 38,
     81 => 233,
     82 => 234,
     83 => 235,
     84 => 232,
     85 => 237,
     86 => 238,
     87 => 239,
     88 => 236,
     89 => 223,
     90 => 33,
     91 => 36,
     92 => 42,
     93 => 41,
     94 => 59,
     95 => 94,
     96 => 45,
     97 => 47,
     98 => 194,
     99 => 196,
    100 => 192,
    101 => 193,
    102 => 195,
    103 => 197,
    104 => 199,
    105 => 209,
    106 => 166,
    107 => 44,
    108 => 37,
    109 => 95,
    110 => 62,
    111 => 63,
    112 => 248,
    113 => 201,
    114 => 202,
    115 => 203,
    116 => 200,
    117 => 205,
    118 => 206,
    119 => 207,
    120 => 204,
    121 => 96,
    122 => 58,
    123 => 35,
    124 => 64,
    125 => 39,
    126 => 61,
    127 => 34,
    128 => 216,
    129 => 97,
    130 => 98,
    131 => 99,
    132 => 100,
    133 => 101,
    134 => 102,
    135 => 103,
    136 => 104,
    137 => 105,
    138 => 171,
    139 => 187,
    140 => 240,
    141 => 253,
    142 => 254,
    143 => 177,
    144 => 176,
    145 => 106,
    146 => 107,
    147 => 108,
    148 => 109,
    149 => 110,
    150 => 111,
    151 => 112,
    152 => 113,
    153 => 114,
    154 => 170,
    155 => 186,
    156 => 230,
    157 => 184,
    158 => 198,
    159 => 164,
    160 => 181,
    161 => 126,
    162 => 115,
    163 => 116,
    164 => 117,
    165 => 118,
    166 => 119,
    167 => 120,
    168 => 121,
    169 => 122,
    170 => 161,
    171 => 191,
    172 => 208,
    173 => 91,
    174 => 222,
    175 => 174,
    176 => 172,
    177 => 163,
    178 => 165,
    179 => 183,
    180 => 169,
    181 => 167,
    182 => 182,
    183 => 188,
    184 => 189,
    185 => 190,
    186 => 221,
    187 => 168,
    188 => 175,
    189 => 93,
    190 => 180,
    191 => 215,
    192 => 123,
    193 => 65,
    194 => 66,
    195 => 67,
    196 => 68,
    197 => 69,
    198 => 70,
    199 => 71,
    200 => 72,
    201 => 73,
    202 => 173,
    203 => 244,
    204 => 246,
    205 => 242,
    206 => 243,
    207 => 245,
    208 => 125,
    209 => 74,
    210 => 75,
    211 => 76,
    212 => 77,
    213 => 78,
    214 => 79,
    215 => 80,
    216 => 81,
    217 => 82,
    218 => 185,
    219 => 251,
    220 => 252,
    221 => 249,
    222 => 250,
    223 => 255,
    224 => 92,
    225 => 247,
    226 => 83,
    227 => 84,
    228 => 85,
    229 => 86,
    230 => 87,
    231 => 88,
    232 => 89,
    233 => 90,
    234 => 178,
    235 => 212,
    236 => 214,
    237 => 210,
    238 => 211,
    239 => 213,
    240 => 48,
    241 => 49,
    242 => 50,
    243 => 51,
    244 => 52,
    245 => 53,
    246 => 54,
    247 => 55,
    248 => 56,
    249 => 57,
    250 => 179,
    251 => 219,
    252 => 220,
    253 => 217,
    254 => 218,
    255 => 159
}